called strikes + whiffs,player_id,player_name,pitch_type,total_pitches,csw_percent,whiffs,called strikes
245,621242,"Díaz, Edwin",SL,539,45.5,170,75
286,662253,"Muñoz, Andrés",SL,662,43.2,194,92
132,664854,"Helsley, Ryan",SL,307,43,91,41
140,666204,"Jiménez, Dany",SL,332,42.2,68,72
112,623352,"Hader, Josh",SL,267,41.9,63,49
57,543238,"Gose, Anthony",SL,136,41.9,30,27
75,656464,"Ginkel, Kevin",SL,180,41.7,39,36
128,472610,"García, Luis",SL,310,41.3,72,56
189,606149,"Gallegos, Giovanny",SL,466,40.6,125,64
67,669358,"Baz, Shane",SL,165,40.6,40,27
142,661403,"Clase, Emmanuel",SL,351,40.5,97,45
79,641755,"Kinley, Tyler",SL,196,40.3,54,25
153,663556,"McClanahan, Shane",SL,380,40.3,95,58
203,453286,"Scherzer, Max",SL,508,40,137,66
178,650556,"Abreu, Bryan",SL,450,39.6,121,57
57,664076,"Cleavinger, Garrett",SL,144,39.6,26,31
183,596112,"Stephenson, Robert",SL,462,39.6,103,80
43,607755,"Vasquez, Andrew",SL,109,39.4,14,29
81,669145,"Zimmermann, Bruce",SL,206,39.3,37,44
55,622786,"Tinoco, Jesus",SL,140,39.3,22,33
130,622663,"Severino, Luis",SL,331,39.3,60,70
157,642701,"Santana, Dennis",SL,401,39.2,77,80
103,571656,"Farmer, Buck",SL,263,39.2,43,60
100,628452,"Iglesias, Raisel",SL,255,39.2,51,49
144,594798,"deGrom, Jacob",SL,369,39,121,23
251,675911,"Strider, Spencer",SL,643,39,157,94
102,519151,"Pressly, Ryan",SL,262,38.9,75,27
139,669276,"Lee, Dylan",SL,360,38.6,102,37
41,663385,"Smith, Chad",SL,107,38.3,28,13
64,547973,"Chapman, Aroldis",SL,167,38.3,30,34
57,664776,"Cousins, Jake",SL,150,38,31,26
116,659275,"Lamet, Dinelson",SL,306,37.9,77,39
141,640462,"Puk, A.J.",SL,373,37.8,76,65
125,663855,"Hicks, Jordan",SL,332,37.7,64,61
76,676477,"Whitlock, Garrett",SL,202,37.6,46,30
86,612434,"Castro, Miguel",SL,229,37.6,42,44
206,542914,"Bass, Anthony",SL,550,37.5,121,85
108,608665,"Graveman, Kendall",SL,288,37.5,55,53
50,664126,"Fairbanks, Pete",SL,134,37.3,20,30
349,506433,"Darvish, Yu",SL,936,37.3,114,235
38,682847,"Ortiz, Luis L.",SL,102,37.3,26,12
162,676714,"Hughes, Brandon",SL,435,37.2,109,53
126,623474,"Herget, Jimmy",SL,339,37.2,45,81
196,622491,"Castillo, Luis",SL,528,37.1,92,104
72,657140,"Wright, Kyle",SL,195,36.9,22,50
41,523260,"Kelly, Joe",SL,111,36.9,27,14
88,660853,"De Los Santos, Enyel",SL,240,36.7,44,44
87,606625,"Moronta, Reyes",SL,237,36.7,40,47
174,519293,"Smith, Will",SL,475,36.6,123,51
136,664747,"Díaz, Alexis",SL,372,36.6,85,51
67,665795,"Cabrera, Edward",SL,183,36.6,36,31
74,622554,"Domínguez, Seranthony",SL,203,36.5,52,22
52,657240,"Merryweather, Julian",SL,143,36.4,25,27
186,605447,"Romano, Jordan",SL,512,36.3,90,96
73,657265,"Strzelecki, Peter",SL,201,36.3,26,47
85,502085,"Robertson, David",SL,235,36.2,47,38
104,605177,"Chafin, Andrew",SL,287,36.2,90,14
177,666808,"Doval, Camilo",SL,489,36.2,101,76
143,670912,"Oviedo, Johan",SL,395,36.2,75,68
46,592848,"Weiss, Zack",SL,127,36.2,28,18
44,642585,"Bautista, Félix",SL,122,36.1,17,27
104,641729,"Jiménez, Joe",SL,289,36,59,45
197,676879,"Ashby, Aaron",SL,549,35.9,102,95
165,666129,"Garrett, Braxton",SL,459,35.9,103,62
138,670167,"Schreiber, John",SL,385,35.8,66,72
80,661309,"Martínez, Adrián",SL,224,35.7,32,48
117,664123,"Effross, Scott",SL,328,35.7,44,73
478,656302,"Cease, Dylan",SL,1338,35.7,301,177
120,663436,"Martin, Davis",SL,337,35.6,79,41
124,642758,"Acevedo, Domingo",SL,348,35.6,90,34
98,600917,"Leclerc, José",SL,277,35.4,59,39
125,666374,"Brash, Matt",SL,353,35.4,67,58
189,605130,"Barlow, Scott",SL,535,35.3,79,110
104,608678,"Leone, Dominic",SL,295,35.3,88,16
121,608328,"De Jong, Chase",SL,343,35.3,70,51
94,657044,"Thompson, Ryan",SL,267,35.2,40,54
53,663432,"Rainey, Tanner",SL,151,35.1,43,10
208,608566,"Márquez, Germán",SL,593,35.1,96,112
247,664299,"Javier, Cristian",SL,705,35,123,124
139,571760,"Heaney, Andrew",SL,398,34.9,101,38
97,669270,"Kuhnel, Joel",SL,278,34.9,40,57
258,543037,"Cole, Gerrit",SL,739,34.9,182,76
111,644364,"Arano, Víctor",SL,318,34.9,76,35
138,667427,"Jackson, Zach",SL,396,34.8,69,69
79,621074,"Rucker, Michael",SL,227,34.8,48,31
79,666159,"Manning, Matt",SL,227,34.8,39,40
46,657272,"Uelmen, Erich",SL,132,34.8,26,20
141,453268,"Bard, Daniel",SL,405,34.8,75,66
70,656546,"Hoffman, Jeff",SL,201,34.8,20,50
89,663986,"Stephan, Trevor",SL,256,34.8,44,45
63,554340,"García, Yimi",SL,182,34.6,18,45
260,680686,"Gray, Josiah",SL,752,34.6,145,115
37,666974,"Cano, Yennier",SL,107,34.6,14,23
78,642152,"Trivino, Lou",SL,227,34.4,45,33
226,595345,"Okert, Steven",SL,659,34.3,109,117
46,686752,"Pepiot, Ryan",SL,134,34.3,17,29
92,622253,"Tate, Dillon",SL,269,34.2,40,52
238,605397,"Musgrove, Joe",SL,696,34.2,115,123
113,680704,"Sandlin, Nick",SL,331,34.1,65,48
194,605483,"Snell, Blake",SL,569,34.1,143,51
187,656849,"Peterson, David",SL,550,34,140,47
34,656420,"Feyereisen, J.P.",SL,100,34,17,17
178,605164,"Bundy, Dylan",SL,523,34,94,84
38,664054,"Stashak, Cody",SL,112,33.9,25,13
131,664161,"Swarmer, Matt",SL,388,33.8,80,51
65,621121,"McCullers Jr., Lance",SL,193,33.7,28,37
162,570666,"Cessa, Luis",SL,481,33.7,71,91
131,456501,"Cueto, Johnny",SL,390,33.6,32,99
39,666818,"Frías, Luis",SL,116,33.6,15,24
126,656557,"Houck, Tanner",SL,375,33.6,60,66
67,641927,"Ober, Bailey",SL,200,33.5,40,27
62,642546,"Hernández, Jonathan",SL,185,33.5,32,30
302,668881,"Greene, Hunter",SL,901,33.5,165,137
169,571479,"Bellatti, Andrew",SL,505,33.5,102,67
247,664141,"Brubaker, JT",SL,739,33.4,166,81
113,656412,"Faedo, Alex",SL,338,33.4,58,55
182,672710,"Contreras, Roansy",SL,547,33.3,127,55
186,579328,"Kikuchi, Yusei",SL,559,33.3,113,73
35,660825,"Bazardo, Eduard",SL,105,33.3,20,15
263,656945,"Scott, Tanner",SL,791,33.2,146,117
91,521230,"Hendriks, Liam",SL,274,33.2,79,12
127,605521,"Warren, Art",SL,382,33.2,66,61
120,593423,"Montas, Frankie",SL,363,33.1,57,63
53,621366,"Borucki, Ryan",SL,160,33.1,34,19
42,543101,"DeSclafani, Anthony",SL,127,33.1,20,22
164,666200,"Luzardo, Jesús",SL,495,33.1,85,79
169,621076,"Kaprielian, James",SL,512,33,92,77
68,663574,"Santillan, Tony",SL,206,33,28,40
53,669212,"Morgan, Eli",SL,161,32.9,32,21
297,663903,"Singer, Brady",SL,903,32.9,165,132
63,663559,"Falter, Bailey",SL,192,32.8,35,28
108,643493,"Pruitt, Austin",SL,329,32.8,54,54
170,608331,"Fried, Max",SL,519,32.8,70,100
48,664294,"Moreta, Dauri",SL,147,32.7,22,26
278,669456,"Bieber, Shane",SL,849,32.7,191,87
42,640448,"Finnegan, Kyle",SL,129,32.6,25,17
142,518553,"Cishek, Steve",SL,436,32.6,57,85
233,645261,"Alcantara, Sandy",SL,714,32.6,110,123
38,658551,"Fernández, Junior",SL,117,32.5,22,16
87,669920,"Alexander, Jason",SL,269,32.3,27,60
127,622694,"Hernández, Elieser",SL,395,32.2,74,53
97,669203,"Burnes, Corbin",SL,301,32.2,74,23
39,542947,"Bleier, Richard",SL,121,32.2,22,17
119,680739,"Winder, Josh",SL,371,32.1,56,63
298,607074,"Rodón, Carlos",SL,929,32.1,170,128
279,641771,"Kuhl, Chad",SL,870,32.1,166,113
135,519326,"Strickland, Hunter",SL,420,32.1,68,67
32,671790,"Bolaños, Ronald",SL,100,32,19,13
189,471911,"Carrasco, Carlos",SL,590,32,117,72
70,678394,"Bello, Brayan",SL,219,32,20,50
104,628708,"Marte, Yunior",SL,325,32,56,48
250,477132,"Kershaw, Clayton",SL,786,31.8,182,68
42,445276,"Jansen, Kenley",SL,132,31.8,14,28
98,681911,"Vesia, Alex",SL,308,31.8,53,45
289,596001,"Junis, Jakob",SL,910,31.8,109,180
113,592761,"Smith, Caleb",SL,357,31.7,62,51
85,669424,"Lambert, Jimmy",SL,270,31.5,43,42
39,605347,"López, Jorge",SL,124,31.5,23,16
167,650895,"Castillo, Diego",SL,531,31.5,89,78
64,656458,"Gilbreath, Lucas",SL,204,31.4,34,30
77,502202,"Boxberger, Brad",SL,245,31.4,22,55
87,622098,"Smith, Drew",SL,277,31.4,49,38
164,668676,"Plesac, Zach",SL,523,31.4,114,50
164,592791,"Taillon, Jameson",SL,523,31.4,71,93
37,677053,"Nardi, Andrew",SL,118,31.4,23,14
37,676050,"Naughton, Packy",SL,118,31.4,15,22
195,607536,"Freeland, Kyle",SL,624,31.3,78,117
40,608638,"Chargois, JT",SL,128,31.3,23,17
45,605463,"Scott, Tayler",SL,144,31.3,20,25
251,622072,"Wood, Alex",SL,805,31.2,118,133
223,663776,"Sandoval, Patrick",SL,715,31.2,137,86
132,518489,"Brasier, Ryan",SL,423,31.2,69,63
79,621016,"Cuas, Jose",SL,253,31.2,47,32
37,669395,"Coleman, Dylan",SL,119,31.1,21,16
73,693821,"Elder, Bryce",SL,235,31.1,37,36
36,643316,"Fry, Paul",SL,116,31,11,25
228,434378,"Verlander, Justin",SL,738,30.9,142,86
50,641447,"Castano, Daniel",SL,162,30.9,19,31
94,571710,"Givens, Mychal",SL,304,30.9,34,60
55,592390,"Hembree, Heath",SL,178,30.9,20,35
166,643511,"Rogers, Tyler",SL,537,30.9,63,103
68,468504,"Chacín, Jhoulys",SL,221,30.8,29,39
221,663738,"Lynch IV, Daniel",SL,720,30.7,129,92
54,672391,"Ort, Kaleb",SL,176,30.7,26,28
55,660787,"De Los Santos, Yerry",SL,179,30.7,28,27
46,656529,"Hentges, Sam",SL,150,30.7,24,22
49,605195,"Crick, Kyle",SL,160,30.6,21,28
82,592716,"Sampson, Adrian",SL,268,30.6,37,45
39,593974,"Peralta, Wandy",SL,128,30.5,30,9
95,664199,"Clarke, Taylor",SL,311,30.5,59,36
63,503449,"Peralta, Wily",SL,207,30.4,17,46
87,605540,"Woodruff, Brandon",SL,286,30.4,51,36
345,592662,"Ray, Robbie",SL,1134,30.4,228,117
41,596082,"Reed, Jake",SL,135,30.4,19,22
73,641816,"Mahle, Tyler",SL,240,30.4,33,40
161,642545,"Barria, Jaime",SL,529,30.4,66,95
94,594577,"Mayers, Mike",SL,310,30.3,48,46
298,657277,"Webb, Logan",SL,982,30.3,132,166
57,571670,"Floro, Dylan",SL,189,30.2,31,26
53,670059,"Holderman, Colin",SL,176,30.1,32,21
50,592773,"Stanek, Ryne",SL,166,30.1,14,36
51,594311,"Gustave, Jandel",SL,170,30,14,37
32,621112,"Blackburn, Paul",SL,107,29.9,18,14
99,572193,"Tepera, Ryan",SL,331,29.9,70,29
99,669618,"Barlow, Joe",SL,333,29.7,54,45
79,572070,"Richards, Garrett",SL,267,29.6,48,31
202,605538,"Wisler, Matt",SL,684,29.5,87,115
31,518748,"Grimm, Justin",SL,105,29.5,13,18
67,676265,"Abbott, Cory",SL,227,29.5,39,28
33,681217,"Silseth, Chase",SL,112,29.5,18,15
50,543339,"Hudson, Daniel",SL,170,29.4,36,14
154,672282,"Detmers, Reid",SL,523,29.4,87,67
36,621111,"Buehler, Walker",SL,123,29.3,28,8
110,669459,"Nelson, Kyle",SL,376,29.3,63,47
36,543507,"May, Trevor",SL,123,29.3,10,26
44,661269,"Gutierrez, Vladimir",SL,150,29.3,20,24
117,592332,"Gausman, Kevin",SL,400,29.3,57,60
49,425844,"Greinke, Zack",SL,168,29.2,20,29
130,663372,"Feltner, Ryan",SL,446,29.1,49,81
132,607237,"Garrett, Amir",SL,454,29.1,70,62
85,669912,"Snead, Kirby",SL,292,29.1,37,48
48,554431,"Matzek, Tyler",SL,165,29.1,28,20
61,656986,"Sousa, Bennett",SL,210,29,34,27
97,672335,"Pérez, Cionel",SL,334,29,44,53
38,660730,"Rodriguez, Elvin",SL,131,29,16,22
65,605135,"Bassitt, Chris",SL,224,29,22,43
116,656353,"Davidson, Tucker",SL,401,28.9,61,55
223,571578,"Corbin, Patrick",SL,771,28.9,129,94
91,641360,"Bickford, Phil",SL,316,28.8,40,51
34,621248,"Garza Jr., Ralph",SL,118,28.8,17,17
170,669373,"Skubal, Tarik",SL,591,28.8,74,96
97,670174,"Winckowski, Josh",SL,337,28.8,39,58
33,617228,"Sawamura, Hirokazu",SL,115,28.7,21,12
37,660813,"Graterol, Brusdar",SL,129,28.7,31,6
226,641745,"Keller, Brad",SL,789,28.6,113,113
50,672578,"Hernández, Carlos",SL,175,28.6,34,16
136,668933,"Ashcraft, Graham",SL,476,28.6,70,66
104,669211,"Akin, Keegan",SL,364,28.6,44,60
55,665625,"Peguero, Elvis",SL,193,28.5,33,22
115,657746,"Ryan, Joe",SL,405,28.4,66,49
71,642547,"Peralta, Freddy",SL,250,28.4,35,36
61,677651,"Garcia, Luis",SL,215,28.4,39,22
227,666201,"Manoah, Alek",SL,798,28.4,127,100
168,680694,"Bradish, Kyle",SL,593,28.3,101,67
47,656427,"Flaherty, Jack",SL,166,28.3,29,18
30,608652,"Farrell, Luke",SL,106,28.3,9,21
201,641540,"Dunning, Dane",SL,710,28.3,114,87
48,661440,"Llovera, Mauricio",SL,170,28.2,28,20
82,592826,"Velasquez, Vince",SL,291,28.2,43,39
88,641329,"Baker, Bryan",SL,312,28.2,29,59
50,607179,"Weems, Jordan",SL,178,28.1,26,24
85,545343,"Head, Louis",SL,303,28.1,39,46
58,656061,"Abreu, Albert",SL,207,28,37,21
141,596295,"Gomber, Austin",SL,507,27.8,82,59
88,625643,"López, Reynaldo",SL,318,27.7,52,36
175,657006,"Steele, Justin",SL,632,27.7,99,76
181,571800,"Hutchison, Drew",SL,653,27.7,89,92
96,669432,"Rogers, Trevor",SL,346,27.7,54,42
51,503285,"O'Day, Darren",SL,184,27.7,21,30
55,600921,"Machado, Andrés",SL,199,27.6,25,30
80,656793,"Nelson, Nick",SL,291,27.5,49,31
86,640455,"Manaea, Sean",SL,314,27.4,42,44
178,608337,"Giolito, Lucas",SL,649,27.4,95,83
38,650204,"Ruiz, Norge",SL,139,27.3,21,17
45,663989,"Vespi, Nick",SL,165,27.3,31,14
145,605488,"Springs, Jeffrey",SL,533,27.2,52,93
41,664092,"Poppen, Sean",SL,151,27.2,15,26
67,605288,"Houser, Adrian",SL,247,27.1,27,40
36,606160,"Montero, Rafael",SL,133,27.1,10,26
95,592789,"Syndergaard, Noah",SL,352,27,34,61
57,608717,"Stratton, Chris",SL,211,27,29,28
99,643256,"Cimber, Adam",SL,369,26.8,30,69
93,660761,"Suarez, José",SL,347,26.8,56,37
51,670090,"Mills, Wyatt",SL,190,26.8,23,28
37,667297,"Nance, Tommy",SL,138,26.8,22,15
33,647315,"Pop, Zach",SL,123,26.8,11,22
39,607625,"Lugo, Seth",SL,146,26.7,16,23
31,658431,"Medina, Adonis",SL,116,26.7,14,17
77,676092,"Snider, Collin",SL,288,26.7,39,38
75,641793,"Littell, Zack",SL,281,26.7,42,33
211,502042,"Archer, Chris",SL,792,26.6,109,102
45,489265,"Romo, Sergio",SL,169,26.6,20,25
91,669467,"Pallante, Andre",SL,344,26.5,35,56
65,675921,"Howard, Spencer",SL,245,26.5,31,34
114,664062,"Gonsolin, Tony",SL,432,26.4,84,30
115,501985,"Minor, Mike",SL,435,26.4,40,75
28,656730,"Megill, Trevor",SL,106,26.4,18,10
49,543243,"Gray, Sonny",SL,186,26.3,18,31
33,621593,"Castro, Anthony",SL,126,26.2,21,12
43,595881,"Beede, Tyler",SL,164,26.2,17,26
123,641778,"Lauer, Eric",SL,470,26.2,66,57
29,676637,"Sanders, Phoenix",SL,111,26.1,15,14
45,657024,"Swanson, Erik",SL,173,26,26,19
34,666721,"Castillo, Max",SL,131,26,17,17
36,572125,"Selman, Sam",SL,139,25.9,19,17
151,605154,"Brebbia, John",SL,587,25.7,74,77
88,606303,"Payamps, Joel",SL,344,25.6,33,55
43,656605,"Keller, Mitch",SL,168,25.6,21,22
32,650911,"Sánchez, Cristopher",SL,125,25.6,14,18
61,642397,"Soto, Gregory",SL,238,25.6,38,23
123,621368,"Hearn, Taylor",SL,480,25.6,59,64
31,544727,"Familia, Jeurys",SL,121,25.6,15,16
70,665665,"Sanmartin, Reiver",SL,275,25.5,43,27
73,606424,"García, Jarlín",SL,287,25.4,25,48
101,605182,"Clevinger, Mike",SL,397,25.4,54,47
123,502043,"Gibson, Kyle",SL,484,25.4,89,34
67,656271,"Burke, Brock",SL,265,25.3,33,34
91,676684,"Vest, Will",SL,360,25.3,52,39
100,570632,"Ureña, José",SL,398,25.1,48,52
26,592346,"González, Chi Chi",SL,104,25,9,17
154,663474,"McKenzie, Triston",SL,616,25,89,65
38,674072,"Henry, Tommy",SL,154,24.7,24,14
106,640444,"Crowe, Wil",SL,430,24.7,65,41
30,642100,"Speier, Gabe",SL,122,24.6,13,17
27,605525,"Wendelken, J.B.",SL,110,24.5,12,15
30,501925,"Smith, Joe",SL,123,24.4,10,20
65,621383,"Banks, Tanner",SL,267,24.3,22,43
27,681810,"Warren, Austin",SL,111,24.3,13,14
25,622250,"Sborz, Josh",SL,103,24.3,16,9
143,641712,"Hudson, Dakota",SL,592,24.2,75,68
121,656629,"Kopech, Michael",SL,503,24.1,51,70
51,543135,"Eovaldi, Nathan",SL,212,24.1,28,23
41,657508,"Baumann, Mike",SL,170,24.1,18,23
31,643290,"Dunn, Justin",SL,129,24,21,10
96,592836,"Walker, Taijuan",SL,400,24,51,45
33,570663,"Robles, Hansel",SL,139,23.7,15,18
38,656731,"Megill, Tylor",SL,161,23.6,21,17
148,554430,"Wheeler, Zack",SL,635,23.3,76,72
44,682051,"Hill, Garrett",SL,189,23.3,21,23
35,608032,"Estévez, Carlos",SL,151,23.2,12,23
185,571945,"Mikolas, Miles",SL,800,23.1,83,102
29,641835,"Mayza, Tim",SL,127,22.8,21,8
61,689225,"Brieske, Beau",SL,267,22.8,27,34
166,669302,"Gilbert, Logan",SL,730,22.7,92,74
37,544365,"Bañuelos, Manny",SL,164,22.6,21,16
25,573186,"Stroman, Marcus",SL,111,22.5,22,3
37,592866,"Williams, Trevor",SL,165,22.4,28,9
100,548389,"Stripling, Ross",SL,446,22.4,39,61
45,669060,"Wilson, Bryse",SL,203,22.2,20,25
44,669022,"Gore, MacKenzie",SL,199,22.1,30,14
43,528748,"Castellanos, Humberto",SL,196,21.9,14,29
49,669169,"Heasley, Jonathan",SL,225,21.8,25,24
34,501381,"Pineda, Michael",SL,157,21.7,23,11
29,656685,"Martin, Brett",SL,136,21.3,22,7
33,671345,"Foley, Jason",SL,156,21.2,22,11
50,641582,"Foster, Matt",SL,236,21.2,31,19
27,543606,"Odorizzi, Jake",SL,129,20.9,10,17
25,670124,"Oller, Adam",SL,120,20.8,12,13
22,459429,"McGee, Jake",SL,108,20.4,11,11
27,623167,"Flexen, Chris",SL,134,20.1,18,9
82,622608,"Senzatela, Antonio",SL,412,19.9,37,45
23,672715,"Patiño, Luis",SL,116,19.8,15,8
35,669923,"Kirby, George",SL,187,18.7,13,22